1. Penumbra of aggravations — countless annoying little problems related to a big problem

2. Coherent argument — a well-organized reasoning without any self-contradictions

3. Substantive contribution — an important piece of study, essential for the field

4. Diffuse activity — the skill in which is spread between researchers by itself

5. Credible resources — ones to which respect is paid

6. Prowess in a discipline — expertise

7. Skills inculcated — taught thoroughly

8. By-product approach — developing something not as a main result of a process

9. Doctoral instruction — the process of writing thesis and receiving knowledge under supervision

10. Humanities and social sciences — гуманитарные науки

11. Set out to write a book — decide to do something huge

12. Grapple with — deal or understand a difficult problem

13. Shelf-bending thesis — one that is never published

14. Apprentice researcher — working for low payment for a more skilled person

15. Dubious kudos — praise that is not certainly there

16. Taught Ph. D

17. Classical Ph. D

18. Professional doctorate

════════════════════════════════

19. Leveled planar graph — a graph drawn on the plane whose vertices are on several parallel lines

20. Layered pathwidth — the maximum size of the intersection between a layer and a bag in a decomposition of a graph

20. Outerplanar graph — a planar graph drawn in a way such that all the vertices are in the outer (unbounded) face

21. Squaregraphs — 4-faces, each vertex either in outer face or has degree 4+

22. Breadth first layering — each vertex is marked by its distance to the source vertex

23. Specify an ordering — assign consequent natural (positive integer) numbers to objects

24. Net — a simple non-overlapping unfolding of a polyhedron

25. Unit-speed parametrization — parametrization by the distance to the origin

26. Osculating circle — the one with the same curvature

27. Unit normal vector — perpendicular, of length 1

28. Principal curvatures — the highest and the lowest cuvatures of a surface at a point

29. A flaw of sorts — same things having different properties

30. Subtended — bounded, contracted

31. Intrinsic — defined from an internal view

32. Geodesic — measured inside surface

33. Elliptic, hyperbolic points — with respect to curvature

34. Angle deficit, Gaussian curvature — the difference between 2*pi and the facial angle at a point

35. Meager evidence — sparse, insufficient

36. Lament — to complain

37. Paucity — sparcity, poverty

38. Star unfolding, source unfolding — methods of unfolding a polyhedron that (supposedly) produce a non-overlapping net

39. Overlap penetration — the ratio of a penetration to the diameter

════════════════════════════════

40. Follow suit — to act conformly

41. Convex hull — a minimal convex polygon containing a given set of points

42. Vertex-edge resolution — a minimal separation between a vertex and a non-incident edge in a drawing

43. Disk-link drawing — a drawing with vertex-edge resolution of at least 1/2

44. Gluing — a pair of a set of polygons and rules specifying how to glue their boundaries

45. Polyhedron — a union of convex polyhedra, which are intersections of half-spaces

46. UDC Problem — a problem of covering a given set of points with the minimal number of unit disks

47. Erdős–Rényi graph — a randomly generated graph with sufficient connectivity

48. Prisoner's dilemma — a noncooperative game about betraying or keeping silent

49. Hawk-dove game — a noncooperative game about showing off or retreating

50. MAXQ — a method of reinforcement learning that takes the next action depending on the output of max-nodes and q-nodes

51. Schnyder labeling — an orientation on a maximal planar graph where each vertex has 3 outcoming edges

52. Canonical ordering of a planar graph — an ordering that helps draw the graph: each next vertex is in the outer face connected with a countinuous segment of previous vertices

53. LR-partition — a partition of all the back-edges with respect to a DFS-ordering into two sets. It helps test planarity of a graph

54. n-connected graph — a graph that remains connected after removal of n-1 vertices

55. Closed rectangle-of-influence drawing — a drawing such that no vertex lies in the axis-parallel rectangle defined by two ends of every edge

56. Bold drawing — vertices are drawn as disks of radius r and edges as rectangles of width w

57. Planar embedding — an equivalence class of topologically-equivalent planar drawings

58. Straight-line drawing — a drawing where all the arcs are straight-line segments

59. Grid drawing — straight-line drawing where vertices have integer coordinates

60. Point density — ratio of |P| to the area of its bounding box

61. Track layout — partition of a graph into tracks, which are independent sets, and edges between them do not cross

62. Tree decomposition — an assignment of bags such that endpoints of any edge share a bag, and each vertex is in a continuous subtree of bags

63. Path decomposition — a tree decomposition but the tree is a path

64. Treewidth — minimal size of a maximal bag -1

65. Minor — a graph obtained by deleting edges / vertices and contracting edges

66. Euler characteristic — V-E+F

67. Euler genus — 1 - chi/2

69. General position — assumptions about data that hold almost often and help evade degenerate cases

════════════════════════════════

70. Hull signature — an ordered list of vertices of the convex hull of a set

71. Dynamic nearest neighbor structure — a structure supporting insertion of a site and the query of the nearest site to a given point

72. Voronoi circle — a circle passing through three adjacent Voronoi sites

73. Sweep line — a line that is moved through the plane used to construct several geometric structures

74. Combinatorial change — a change in the graph of a structure, not only in the location of its vertices

75. Affirm — show that one has obtained a message and has no objections

76. Visibility center — a point such that the maximum geodesic distance from it to _see_ any point in the set is minimized

77. Book embedding — a drawing of a graph on several half-planes glued along their boundary

78. Abuse of notation — using the same denotion for objects of different generality

79. Winding number — the number of counterclockwise rotations of a curve around a point

80. Young diagram — a way to demonstrate integer partitions

81. Bipartite graph — a graph colored in black and white in a way that each edge has endpoints of distinct colors

82. Spanning tree — a tree obtained by deletion of several edges from a graph, but on the same set of vertices

83. Building greedily — taking a maximal possible set on each step

84. Minor-closed class — a class such that if G is in it, every minor of G is in it

85. Dual graph — a graph whose vertices are faces of G and whose edges are edges incident to these faces

════════════════════════════════

86. Geodesic center —  a point that minimizes the maximum geodesic distance from it to any point of the set

87. Chord — a segment inside a polygon intersecting its boundary only at endpoints

88. Geodesically convex subset — a subset such that if two points lie in it, so does the geodesic shortest path between them

89. Pareto optimality — a situation where no individual or preference criterion can be better off without making at least one individual or preference criterion worse off

90. Nash equilibrium — each player is assumed to know the equilibrium strategies of the other players, and no one has anything to gain by changing only one's own strategy

91. Oracle — a thing that is somehow able to solve a complicated problem in constant time

92. Winning strategy — a sequence of actions that depends on a position in a game that makes a player win the game

93. DFS — graph traversal that first goes as deep as possible along the edges

94. BFS — graph traversal that considers all the vertice's neighbors immediately after this vertex

95. Manifold — a topological space with continuous base that is locally homeomorphic to Euclidean space

96. Base — a set of sets such that any open set of the topology can be represented as a union of the sets in the base

97. Curry—Howard isomorphism — a mapping between habitable types and provable statements
